ASSIGNMENT 1 : RLI_08_00 

GROUP 0 : MANUEL SAN ROMÁN GARCÍA, CARLO PASTOR MONTRUCCHIO, SOPHIE FRANCES MORGAN
GROUP 1 : MAJD A. N. BARGHOUTI, ANTHONY YAACOUB, FARAH SAMIR YOUSEF ABUATIYEH
GROUP 2 : ZANE KENDALL REDA, MARTA GARCÍA DEL VALLE, MIKHAILE DOUGLAS COLLINS
GROUP 3 : FRANCISCO HESHIKI DE LAS CASAS, YOUSSEF WALID HUSSEINY AHMED, JUAN JOSÉ RUBIALES VILLEGAS
GROUP 4 : DIEGO SANMARTÍN CARRIÓN, YOUSIF IMAD AL-SAFFAR
GROUP 5 : ALEJANDRO FELIPE PÉREZ VARGAS, LORENZ HORST EHRLICH, TOMÁS CAMILO VINTIMILLA
GROUP 6 : ANTONIO BENJAMÍN FERNÁNDEZ, ISMAEL DOUKKALI-SADIQUI, VERA PROHASKA
GROUP 7 : BOUMEDIENE RAYANE MAZARI, YAHYA LARAQUI HOUSSAINI, DYANNA MONIQUE RIVERA
GROUP 8 : JOAQUÍN CASASÚS CALVO, BELTRÁN VALLE GUTIÉRREZ, SAAD ALI SAHIR
GROUP 9 : BARTOSZ MICHAL RZYCKI, HENNING GRUHL CAÑARDO, JOSÉ PABLO BELLO PAZ
GROUP 10 : ALEJANDRO ESCOBIO FIDALGO, ALEJANDRO GALVEZ LOPEZ, RABINDRA ADHIKARI
GROUP 11 : TAMAR ALPHAIDZE, CARLOS TAPIA OLIVEIRA, PABLO ORTEGA GAYO

FARAH SAMIR YOUSEF ABUATIYEH : GROUP 1 WITH MAJD A. N. BARGHOUTI, ANTHONY YAACOUB
RABINDRA ADHIKARI : GROUP 10 WITH ALEJANDRO ESCOBIO FIDALGO, ALEJANDRO GALVEZ LOPEZ
YOUSSEF WALID HUSSEINY AHMED : GROUP 3 WITH FRANCISCO HESHIKI DE LAS CASAS, JUAN JOSÉ RUBIALES VILLEGAS
TAMAR ALPHAIDZE : GROUP 11 WITH CARLOS TAPIA OLIVEIRA, PABLO ORTEGA GAYO
YOUSIF IMAD AL-SAFFAR : GROUP 4 WITH DIEGO SANMARTÍN CARRIÓN
MAJD A. N. BARGHOUTI : GROUP 1 WITH ANTHONY YAACOUB, FARAH SAMIR YOUSEF ABUATIYEH
JOSÉ PABLO BELLO PAZ : GROUP 9 WITH BARTOSZ MICHAL RZYCKI, HENNING GRUHL CAÑARDO
JOAQUÍN CASASÚS CALVO : GROUP 8 WITH BELTRÁN VALLE GUTIÉRREZ, SAAD ALI SAHIR
MIKHAILE DOUGLAS COLLINS : GROUP 2 WITH ZANE KENDALL REDA, MARTA GARCÍA DEL VALLE
ISMAEL DOUKKALI-SADIQUI : GROUP 6 WITH ANTONIO BENJAMÍN FERNÁNDEZ, VERA PROHASKA
LORENZ HORST EHRLICH : GROUP 5 WITH ALEJANDRO FELIPE PÉREZ VARGAS, TOMÁS CAMILO VINTIMILLA
ALEJANDRO ESCOBIO FIDALGO : GROUP 10 WITH ALEJANDRO GALVEZ LOPEZ, RABINDRA ADHIKARI
ANTONIO BENJAMÍN FERNÁNDEZ : GROUP 6 WITH ISMAEL DOUKKALI-SADIQUI, VERA PROHASKA
ALEJANDRO GALVEZ LOPEZ : GROUP 10 WITH ALEJANDRO ESCOBIO FIDALGO, RABINDRA ADHIKARI
MARTA GARCÍA DEL VALLE : GROUP 2 WITH ZANE KENDALL REDA, MIKHAILE DOUGLAS COLLINS
HENNING GRUHL CAÑARDO : GROUP 9 WITH BARTOSZ MICHAL RZYCKI, JOSÉ PABLO BELLO PAZ
FRANCISCO HESHIKI DE LAS CASAS : GROUP 3 WITH YOUSSEF WALID HUSSEINY AHMED, JUAN JOSÉ RUBIALES VILLEGAS
YAHYA LARAQUI HOUSSAINI : GROUP 7 WITH BOUMEDIENE RAYANE MAZARI, DYANNA MONIQUE RIVERA
BOUMEDIENE RAYANE MAZARI : GROUP 7 WITH YAHYA LARAQUI HOUSSAINI, DYANNA MONIQUE RIVERA
PABLO ORTEGA GAYO : GROUP 11 WITH TAMAR ALPHAIDZE, CARLOS TAPIA OLIVEIRA
CARLO PASTOR MONTRUCCHIO : GROUP 0 WITH MANUEL SAN ROMÁN GARCÍA, SOPHIE FRANCES MORGAN
ALEJANDRO FELIPE PÉREZ VARGAS : GROUP 5 WITH LORENZ HORST EHRLICH, TOMÁS CAMILO VINTIMILLA
VERA PROHASKA : GROUP 6 WITH ANTONIO BENJAMÍN FERNÁNDEZ, ISMAEL DOUKKALI-SADIQUI
ZANE KENDALL REDA : GROUP 2 WITH MARTA GARCÍA DEL VALLE, MIKHAILE DOUGLAS COLLINS
DYANNA MONIQUE RIVERA : GROUP 7 WITH BOUMEDIENE RAYANE MAZARI, YAHYA LARAQUI HOUSSAINI
JUAN JOSÉ RUBIALES VILLEGAS : GROUP 3 WITH FRANCISCO HESHIKI DE LAS CASAS, YOUSSEF WALID HUSSEINY AHMED
BARTOSZ MICHAL RZYCKI : GROUP 9 WITH HENNING GRUHL CAÑARDO, JOSÉ PABLO BELLO PAZ
SAAD ALI SAHIR : GROUP 8 WITH JOAQUÍN CASASÚS CALVO, BELTRÁN VALLE GUTIÉRREZ
DIEGO SANMARTÍN CARRIÓN : GROUP 4 WITH YOUSIF IMAD AL-SAFFAR
MANUEL SAN ROMÁN GARCÍA : GROUP 0 WITH CARLO PASTOR MONTRUCCHIO, SOPHIE FRANCES MORGAN
CARLOS TAPIA OLIVEIRA : GROUP 11 WITH TAMAR ALPHAIDZE, PABLO ORTEGA GAYO
BELTRÁN VALLE GUTIÉRREZ : GROUP 8 WITH JOAQUÍN CASASÚS CALVO, SAAD ALI SAHIR
TOMÁS CAMILO VINTIMILLA : GROUP 5 WITH ALEJANDRO FELIPE PÉREZ VARGAS, LORENZ HORST EHRLICH
ANTHONY YAACOUB : GROUP 1 WITH MAJD A. N. BARGHOUTI, FARAH SAMIR YOUSEF ABUATIYEH
SOPHIE FRANCES MORGAN : GROUP 0 WITH MANUEL SAN ROMÁN GARCÍA, CARLO PASTOR MONTRUCCHIO
