ASSIGNMENT 0 : RLI_05_00 

GROUP 0 : MANUEL SAN ROMÁN GARCÍA, MAJD A. N. BARGHOUTI, ZANE KENDALL REDA
GROUP 1 : CARLO PASTOR MONTRUCCHIO, ANTHONY YAACOUB, MARTA GARCÍA DEL VALLE
GROUP 2 : SOPHIE FRANCES MORGAN, FARAH SAMIR YOUSEF ABUATIYEH, MIKHAILE DOUGLAS COLLINS
GROUP 3 : FRANCISCO HESHIKI DE LAS CASAS, ALEJANDRO FELIPE PÉREZ VARGAS
GROUP 4 : YOUSSEF WALID HUSSEINY AHMED, DIEGO SANMARTÍN CARRIÓN, LORENZ HORST EHRLICH
GROUP 5 : JUAN JOSÉ RUBIALES VILLEGAS, YOUSIF IMAD AL-SAFFAR, TOMÁS CAMILO VINTIMILLA
GROUP 6 : ANTONIO BENJAMÍN FERNÁNDEZ, BOUMEDIENE RAYANE MAZARI, JOAQUÍN CASASÚS CALVO
GROUP 7 : ISMAEL DOUKKALI-SADIQUI, YAHYA LARAQUI HOUSSAINI, BELTRÁN VALLE GUTIÉRREZ
GROUP 8 : VERA PROHASKA, DYANNA MONIQUE RIVERA, SAAD ALI SAHIR
GROUP 9 : BARTOSZ MICHAL RZYCKI, ALEJANDRO ESCOBIO FIDALGO, TAMAR ALPHAIDZE
GROUP 10 : ALEJANDRO GALVEZ LOPEZ, CARLOS TAPIA OLIVEIRA, HENNING GRUHL CAÑARDO
GROUP 11 : JOSÉ PABLO BELLO PAZ, RABINDRA ADHIKARI, PABLO ORTEGA GAYO

FARAH SAMIR YOUSEF ABUATIYEH : GROUP 2 WITH SOPHIE FRANCES MORGAN, MIKHAILE DOUGLAS COLLINS
RABINDRA ADHIKARI : GROUP 11 WITH JOSÉ PABLO BELLO PAZ, PABLO ORTEGA GAYO
YOUSSEF WALID HUSSEINY AHMED : GROUP 4 WITH DIEGO SANMARTÍN CARRIÓN, LORENZ HORST EHRLICH
TAMAR ALPHAIDZE : GROUP 9 WITH BARTOSZ MICHAL RZYCKI, ALEJANDRO ESCOBIO FIDALGO
YOUSIF IMAD AL-SAFFAR : GROUP 5 WITH JUAN JOSÉ RUBIALES VILLEGAS, TOMÁS CAMILO VINTIMILLA
MAJD A. N. BARGHOUTI : GROUP 0 WITH MANUEL SAN ROMÁN GARCÍA, ZANE KENDALL REDA
JOSÉ PABLO BELLO PAZ : GROUP 11 WITH RABINDRA ADHIKARI, PABLO ORTEGA GAYO
JOAQUÍN CASASÚS CALVO : GROUP 6 WITH ANTONIO BENJAMÍN FERNÁNDEZ, BOUMEDIENE RAYANE MAZARI
MIKHAILE DOUGLAS COLLINS : GROUP 2 WITH SOPHIE FRANCES MORGAN, FARAH SAMIR YOUSEF ABUATIYEH
ISMAEL DOUKKALI-SADIQUI : GROUP 7 WITH YAHYA LARAQUI HOUSSAINI, BELTRÁN VALLE GUTIÉRREZ
LORENZ HORST EHRLICH : GROUP 4 WITH YOUSSEF WALID HUSSEINY AHMED, DIEGO SANMARTÍN CARRIÓN
ALEJANDRO ESCOBIO FIDALGO : GROUP 9 WITH BARTOSZ MICHAL RZYCKI, TAMAR ALPHAIDZE
ANTONIO BENJAMÍN FERNÁNDEZ : GROUP 6 WITH BOUMEDIENE RAYANE MAZARI, JOAQUÍN CASASÚS CALVO
ALEJANDRO GALVEZ LOPEZ : GROUP 10 WITH CARLOS TAPIA OLIVEIRA, HENNING GRUHL CAÑARDO
MARTA GARCÍA DEL VALLE : GROUP 1 WITH CARLO PASTOR MONTRUCCHIO, ANTHONY YAACOUB
HENNING GRUHL CAÑARDO : GROUP 10 WITH ALEJANDRO GALVEZ LOPEZ, CARLOS TAPIA OLIVEIRA
FRANCISCO HESHIKI DE LAS CASAS : GROUP 3 WITH ALEJANDRO FELIPE PÉREZ VARGAS
YAHYA LARAQUI HOUSSAINI : GROUP 7 WITH ISMAEL DOUKKALI-SADIQUI, BELTRÁN VALLE GUTIÉRREZ
BOUMEDIENE RAYANE MAZARI : GROUP 6 WITH ANTONIO BENJAMÍN FERNÁNDEZ, JOAQUÍN CASASÚS CALVO
PABLO ORTEGA GAYO : GROUP 11 WITH JOSÉ PABLO BELLO PAZ, RABINDRA ADHIKARI
CARLO PASTOR MONTRUCCHIO : GROUP 1 WITH ANTHONY YAACOUB, MARTA GARCÍA DEL VALLE
ALEJANDRO FELIPE PÉREZ VARGAS : GROUP 3 WITH FRANCISCO HESHIKI DE LAS CASAS
VERA PROHASKA : GROUP 8 WITH DYANNA MONIQUE RIVERA, SAAD ALI SAHIR
ZANE KENDALL REDA : GROUP 0 WITH MANUEL SAN ROMÁN GARCÍA, MAJD A. N. BARGHOUTI
DYANNA MONIQUE RIVERA : GROUP 8 WITH VERA PROHASKA, SAAD ALI SAHIR
JUAN JOSÉ RUBIALES VILLEGAS : GROUP 5 WITH YOUSIF IMAD AL-SAFFAR, TOMÁS CAMILO VINTIMILLA
BARTOSZ MICHAL RZYCKI : GROUP 9 WITH ALEJANDRO ESCOBIO FIDALGO, TAMAR ALPHAIDZE
SAAD ALI SAHIR : GROUP 8 WITH VERA PROHASKA, DYANNA MONIQUE RIVERA
DIEGO SANMARTÍN CARRIÓN : GROUP 4 WITH YOUSSEF WALID HUSSEINY AHMED, LORENZ HORST EHRLICH
MANUEL SAN ROMÁN GARCÍA : GROUP 0 WITH MAJD A. N. BARGHOUTI, ZANE KENDALL REDA
CARLOS TAPIA OLIVEIRA : GROUP 10 WITH ALEJANDRO GALVEZ LOPEZ, HENNING GRUHL CAÑARDO
BELTRÁN VALLE GUTIÉRREZ : GROUP 7 WITH ISMAEL DOUKKALI-SADIQUI, YAHYA LARAQUI HOUSSAINI
TOMÁS CAMILO VINTIMILLA : GROUP 5 WITH JUAN JOSÉ RUBIALES VILLEGAS, YOUSIF IMAD AL-SAFFAR
ANTHONY YAACOUB : GROUP 1 WITH CARLO PASTOR MONTRUCCHIO, MARTA GARCÍA DEL VALLE
SOPHIE FRANCES MORGAN : GROUP 2 WITH FARAH SAMIR YOUSEF ABUATIYEH, MIKHAILE DOUGLAS COLLINS
